Name=Parkour

#Goal window
MsgRace=This parkour is over %d checkpoints, check the scoreboard for the number of completed checkpoints per player.
MsgRaceWon=Congratulations, you have won this parkour!
MsgRaceWonTeam=Congratulations, your team has won this parkour!
MsgRaceLost=You have lost this parkour.
MsgRaceLostTeam=Your team has lost this parkour.

#Respawn
MsgRespawn0=%s tries again.
MsgRespawn1=%s has died.
MsgRespawn2=Haha, %s!
MsgRespawn3=We're mourning %s.
MsgNewRespawn=You'll now respawn here.

#Description
MsgDescFirst=You are in| first place.
MsgDescSecond=You are in| second place.
MsgDescThird=You are in| third place.
MsgDescNth=You are in| %dth place.
MsgDescTeamFirst=Your team is| in first place.
MsgDescTeamSecond=Your team is| in second place.
MsgDescTeamThird=Your team is| in third place.
MsgDescTeamNth=Your team is |in %dth place.

#Scoreboard
MsgCaptionX=Parkour over %d checkpoints.
MsgCaptionNone=Parkour without checkpoints.

#Best time
MsgBestTime=%s has set a new personal best time of %s.

#Evaluation data
MsgEvalPlrWon=%s has won the parkour in %s.
MsgEvalTeamWon=The team %s has won the parkour in %s.
MsgEvalPlayerX=You have cleared %d checkpoints.
MsgEvalPlayerAll=You have cleared all checkpoints.
